6 6 5 5 5 5 5 5 5 5 5 5 5 5 7 7
6 6 5 4 4 4 4 4 4 4 4 4 4 5 6 7
6 6 5 4 2 1 0 1 2 0 2 1 4 5 6 6
6 6 5 4 1 0 2 2 0 2 1 0 4 5 6 6
6 6 5 4 2 1 0 1 2 1 0 2 4 5 6 6
6 6 5 4 0 1 0 2 1 0 2 1 4 5 6 6
6 6 5 4 4 4 4 3 3 4 4 4 4 5 6 6
6 6 5 5 5 5 4 3 3 4 5 5 5 5 6 6
6 6 6 6 6 5 4 3 3 4 5 6 6 6 6 6
7 6 6 6 6 5 4 3 3 4 5 6 6 6 6 6
7 7 6 6 6 5 4 3 3 4 5 6 6 6 6 6
7 7 7 6 6 5 4 3 3 4 5 6 6 6 6 6