5 5 5 5 5 5 5 5 5 5 5 5 5 5 5 5 5 5 5 5 5 5 5 5 5 5 5 5 5 5 5 5 5 5 5 5 5 5 5 5 5 5 5 5 5 5 5 5 5 5
5 7 7 7 7 6 0 0 0 0 0 0 0 0 0 0 0 0 4 4 4 4 4 4 4 4 4 4 4 4 4 4 4 0 0 0 0 0 0 0 0 0 0 12 7 7 7 7 7 5
5 7 7 7 7 6 0 0 0 0 0 0 0 0 0 0 0 0 4 5 6 1 2 1 2 1 2 1 2 1 6 5 4 0 0 0 0 0 0 0 0 0 0 12 7 7 7 7 7 5
5 7 7 7 7 6 0 0 0 0 0 10 0 0 0 0 0 0 4 6 6 2 1 2 1 2 1 2 1 2 6 6 4 0 0 0 0 0 0 0 0 0 0 12 7 7 7 7 7 5
5 7 7 7 7 6 0 0 0 0 0 0 10 0 0 0 0 0 4 6 6 1 2 1 2 1 2 1 2 1 6 6 4 0 0 0 0 0 0 0 0 0 0 12 7 7 7 7 7 5
5 6 6 6 6 6 0 0 0 0 0 0 0 0 0 0 0 0 4 5 6 2 1 2 1 2 1 2 1 2 6 5 4 0 0 0 0 0 0 0 0 0 0 12 12 12 12 12 12 5
5 0 0 0 0 0 0 0 0 0 0 0 0 0 0 0 0 0 4 4 4 4 4 4 4 3 4 4 4 4 4 4 4 0 0 0 0 9 8 0 0 0 0 0 0 0 0 0 0 5
5 0 0 0 0 12 0 0 0 0 0 0 0 0 0 0 0 0 0 0 0 0 3 3 3 3 0 0 0 0 0 0 0 0 0 0 0 8 8 0 0 0 0 0 0 0 0 0 0 5
5 0 0 0 0 12 13 13 0 0 0 0 0 10 0 0 0 0 0 0 0 0 3 0 0 0 0 0 0 0 0 0 0 0 0 0 0 0 0 0 0 0 0 0 0 0 0 0 0 5
5 0 0 0 0 0 0 13 0 0 0 0 0 10 10 0 0 0 0 0 0 0 3 0 0 0 0 0 0 0 0 0 0 0 0 0 0 0 0 0 0 0 0 0 0 0 0 0 0 5
5 0 0 0 0 0 0 0 0 0 0 0 0 0 0 0 0 0 0 0 0 0 3 3 3 3 3 3 3 3 3 3 3 3 3 0 0 0 0 0 0 0 0 0 0 0 0 0 0 5
5 4 4 4 4 4 4 0 0 0 0 0 0 0 0 0 0 0 0 0 0 0 3 0 0 0 0 0 0 0 0 0 0 0 3 0 0 0 0 0 0 0 0 0 0 0 0 0 0 5
5 4 1 2 1 2 4 0 0 0 0 0 0 0 0 0 0 0 0 0 0 0 3 0 0 0 0 0 0 0 4 4 4 4 3 4 4 4 4 0 0 0 0 0 0 0 0 0 0 5
5 4 2 1 2 1 4 0 0 0 0 0 0 0 0 0 0 0 0 0 0 0 3 0 0 0 0 0 0 0 4 5 5 5 1 5 5 5 4 0 0 0 0 9 9 0 0 0 0 5
5 4 1 2 1 2 3 3 3 3 3 3 3 0 0 0 0 0 0 11 0 0 3 0 0 0 0 0 0 0 4 5 2 1 2 1 2 5 4 0 0 0 0 0 8 0 0 0 0 5
5 4 2 1 2 1 4 0 0 0 0 0 3 0 0 0 0 0 9 11 0 0 3 0 0 0 0 0 0 0 4 5 5 5 5 5 5 5 4 0 0 0 0 0 0 0 0 0 0 5
5 4 1 2 1 2 4 0 0 0 0 0 3 0 0 0 0 0 0 0 0 0 3 0 0 0 0 0 0 0 4 4 4 4 4 4 4 4 4 0 0 0 0 0 0 0 0 0 0 5
5 4 4 4 4 4 4 0 0 0 0 0 3 3 3 3 3 3 3 3 3 3 3 0 0 0 0 0 0 0 0 0 0 0 0 0 0 0 0 0 0 0 0 0 0 0 0 0 0 5
5 0 0 0 0 0 0 0 0 0 0 0 0 3 0 0 0 0 0 0 0 0 0 0 11 0 0 0 0 0 0 0 0 0 0 0 0 0 0 0 0 4 4 4 4 4 0 0 0 5
5 0 0 0 0 0 0 0 0 0 0 0 0 3 0 0 0 0 0 0 0 0 0 0 0 10 0 0 0 0 0 0 0 0 0 0 0 0 0 0 0 4 1 2 1 4 0 0 0 5
5 0 0 0 0 10 0 0 0 0 10 12 0 3 0 0 0 0 0 0 0 0 10 0 0 0 0 0 0 0 0 0 0 0 0 0 0 0 0 0 0 4 2 1 2 4 0 0 0 5
5 0 0 0 0 10 0 0 0 0 11 10 0 3 0 0 0 0 0 0 0 0 0 0 0 0 0 0 0 0 0 0 0 0 3 3 3 3 3 3 3 3 1 2 1 4 0 0 0 5
5 0 0 0 0 0 0 0 0 0 0 0 0 3 0 0 0 0 12 12 0 0 6 6 6 6 6 0 0 0 0 0 0 0 3 0 0 0 0 0 0 4 2 1 2 4 0 0 0 5
5 0 0 0 0 0 0 12 12 0 0 0 0 3 0 0 0 0 13 0 0 0 6 9 9 9 6 0 0 0 0 0 0 0 3 0 0 0 0 0 0 4 1 2 1 4 0 0 0 5
5 0 0 0 0 0 0 0 11 0 0 0 0 3 0 0 0 0 0 0 0 0 6 8 0 8 6 0 0 0 0 0 0 0 3 0 0 0 0 0 0 4 4 4 4 4 0 0 0 5
5 0 0 0 0 0 0 0 0 0 0 0 0 3 0 0 0 0 0 0 0 0 6 8 0 8 6 0 0 0 0 0 0 0 3 0 0 0 0 0 0 0 0 0 0 0 0 0 0 5
5 0 0 0 0 0 0 0 0 0 0 0 0 3 0 0 0 0 0 0 0 0 0 0 3 0 0 0 0 0 0 0 0 0 3 0 0 0 0 0 0 0 0 0 0 0 0 0 0 5
5 0 0 0 0 3 3 3 3 3 3 3 3 3 0 0 0 0 0 0 0 0 0 0 3 0 0 0 0 0 0 0 0 0 3 0 0 0 0 0 0 0 0 0 0 0 0 0 0 5
5 4 4 4 4 3 0 0 0 0 0 0 0 0 0 0 0 0 0 0 0 0 0 0 3 0 0 0 0 0 0 0 0 0 3 0 0 0 0 0 0 0 0 0 0 0 0 0 0 5
5 1 2 0 4 3 0 0 0 0 0 0 0 0 0 0 0 0 0 0 0 0 0 0 3 3 3 3 3 3 3 3 3 3 3 0 0 0 0 0 0 0 0 0 0 0 0 0 0 5
5 2 0 1 3 3 0 0 0 0 10 0 0 0 0 0 0 0 0 0 0 0 0 0 0 0 0 0 0 0 0 0 0 0 3 0 0 0 0 0 0 0 0 0 0 0 0 0 0 5
5 1 2 0 4 3 0 0 0 0 0 0 0 0 0 0 12 12 12 12 12 12 12 12 0 0 0 0 0 0 0 0 0 0 3 0 0 0 0 0 0 0 0 0 0 0 0 0 0 5
5 4 4 4 4 3 0 0 0 0 0 0 0 0 0 0 12 4 4 4 4 4 4 4 4 4 4 12 0 0 0 0 0 0 3 0 0 0 0 0 0 0 0 0 0 0 0 0 0 5
5 7 7 7 7 3 0 0 0 0 0 0 10 10 0 0 12 4 1 2 1 2 1 2 1 2 4 12 0 0 0 0 0 0 3 0 0 0 0 0 0 0 4 4 4 4 4 4 4 5
5 7 7 7 7 3 0 0 0 0 0 0 0 10 0 0 12 4 2 1 2 1 2 1 2 1 4 12 0 0 0 0 0 0 3 0 0 0 0 0 0 0 4 2 1 2 1 2 4 5
5 7 7 7 7 3 0 0 0 0 0 0 0 0 0 0 12 4 1 2 1 2 1 2 1 2 4 12 0 0 0 0 0 0 3 0 0 0 0 0 0 0 4 1 2 1 2 1 4 5
5 7 7 7 7 3 0 0 10 0 0 0 0 0 0 0 12 4 4 4 4 4 3 4 4 4 4 12 0 0 0 0 0 0 3 0 0 0 0 0 0 0 4 2 1 2 1 2 4 5
5 7 7 7 7 3 0 0 0 0 0 0 0 0 0 0 12 12 12 12 12 12 3 12 12 12 12 12 0 0 0 0 0 0 3 0 0 0 0 0 0 0 4 4 4 3 4 4 4 5
5 7 7 7 7 3 0 0 0 0 0 0 0 0 0 0 0 0 0 0 0 0 3 0 0 0 0 0 0 0 0 0 0 0 3 0 0 0 0 0 0 0 0 0 0 3 0 0 0 5
5 7 7 7 7 3 0 0 13 0 0 9 0 0 0 0 0 0 0 0 0 0 3 0 0 0 0 0 0 0 0 0 0 0 3 0 0 0 0 0 0 0 0 0 0 3 0 0 0 5
5 3 3 3 3 3 3 3 3 3 3 0 0 0 0 0 0 0 0 0 0 0 3 0 0 0 0 0 0 0 0 0 0 0 3 0 0 0 0 0 0 0 0 0 0 3 0 0 0 5
5 7 7 7 7 7 7 7 7 7 3 0 0 0 0 0 0 0 0 0 0 0 3 0 0 0 0 0 0 0 0 0 0 0 3 0 0 0 0 0 0 0 0 0 0 3 0 0 0 5
5 7 7 7 7 7 7 7 7 7 3 12 0 0 0 0 0 0 0 0 0 0 3 0 0 0 0 0 0 0 0 0 0 0 3 3 3 3 3 3 3 3 3 3 3 3 0 0 0 5
5 7 7 7 7 7 7 7 7 7 3 0 0 0 0 0 0 0 0 0 0 0 3 0 0 0 0 0 0 0 0 0 0 0 0 0 0 0 0 0 0 0 0 0 12 3 0 0 0 5
5 7 7 7 7 7 7 7 7 7 3 0 0 0 0 0 0 0 0 0 11 0 3 0 0 11 0 0 0 9 8 0 0 0 0 0 0 0 0 0 0 0 0 0 0 3 0 0 0 5
5 7 7 7 7 7 7 7 7 7 3 9 0 0 0 0 12 3 3 3 3 3 3 3 3 3 3 3 3 3 0 0 0 0 0 0 0 0 0 0 0 0 0 0 12 3 0 0 0 5
5 7 7 7 7 7 7 7 7 7 3 0 0 0 0 0 0 3 7 7 7 7 7 7 7 7 7 7 7 3 12 0 0 0 0 0 0 0 0 0 0 0 0 0 0 3 0 0 0 5
5 7 7 7 7 7 7 7 7 7 3 0 0 9 0 0 13 3 7 7 7 7 7 7 7 7 7 7 7 3 8 0 12 0 0 0 13 0 0 13 0 0 0 12 0 3 0 0 0 5
5 7 7 7 7 7 7 7 7 7 3 3 3 3 3 3 3 3 7 7 7 7 7 7 7 7 7 7 7 3 3 3 3 3 3 3 3 3 3 3 3 3 3 3 3 3 0 0 0 5
5 5 5 5 5 5 5 5 5 5 5 5 5 5 5 5 5 5 5 5 5 5 5 5 5 5 5 5 5 5 5 5 5 5 5 5 5 5 5 5 5 5 5 5 5 5 5 5 5 5